############################################
#                                          #
#                                          #
#                                          #
#                                          #
#                #####                     #
#                #####                     #
#                #####                     #
#                                          #
#                                          #
#                                          #
#                                          #
#                           #####          #
#                           #####          #
#                           #####          #
#                                          #
#                                          #
#                                          #
############################################